Content -> PaddedFunctions | Whitespace
Whitespace -> WhitespaceCharacters
WhitespaceCharacters -> WhitespaceCharacters? WhitespaceCharacter
WhitespaceCharacter -> " " | "\t" | "\n"
PaddedFunctions -> Whitespace? Functions Whitespace?
Functions -> SeparatedFunctions? Function
SeparatedFunctions -> Functions Whitespace?
Function -> SeparatedFunctionHeader? FunctionBody
Word -> WordCharacters
WordCharacters -> WordCharacters? WordCharacter
WordCharacter -> "a" | "b" | "c" | "d" | "e" | "f" | "g" | "h" | "i" | "j" | "k" | "l" | "m" | "n" | "o" | "p" | "q" | "r" | "s" | "t" | "u" | "v" | "w" | "x" | "y" | "z" | "0" | "1" | "2" | "3" | "4" | "5" | "6" | "7" | "8" | "9"
PaddedVariableName -> Whitespace? VariableName Whitespace?
VariableName -> Word
SeparatedFunctionHeader -> FunctionHeader Whitespace?
FunctionHeader -> EndingWithWordFunctionHeaderSegments | EndingWithKnownFunctionHeaderSegments | EndingWithUnknownFunctionHeaderSegments
EndingWithWordFunctionHeaderSegments -> (SeparatedFunctionHeaderSegments | EndingWithKnownFunctionHeaderSegments | EndingWithUnknownFunctionHeaderSegments)? WordFunctionHeaderSegment
WordFunctionHeaderSegment -> Word
SeparatedFunctionHeaderSegments -> (EndingWithWordFunctionHeaderSegments | EndingWithKnownFunctionHeaderSegments | EndingWithUnknownFunctionHeaderSegments) Whitespace
EndingWithKnownFunctionHeaderSegments -> (SeparatedFunctionHeaderSegments | EndingWithKnownFunctionHeaderSegments | EndingWithUnknownFunctionHeaderSegments | EndingWithWordFunctionHeaderSegments)? KnownFunctionHeaderSegment
KnownFunctionHeaderSegment -> "(" KnownFunctionHeaderSegmentContent? ")"
KnownFunctionHeaderSegmentContent -> Whitespace | PaddedVariableName
EndingWithUnknownFunctionHeaderSegments -> (SeparatedFunctionHeaderSegments | EndingWithKnownFunctionHeaderSegments | EndingWithUnknownFunctionHeaderSegments | EndingWithWordFunctionHeaderSegments)? UnknownFunctionHeaderSegment
UnknownFunctionHeaderSegment -> "[" UnknownFunctionHeaderSegmentContent? "]"
UnknownFunctionHeaderSegmentContent -> Whitespace | PaddedVariableName
FunctionBody -> Block
Block -> "{" BlockContent? "}"
BlockContent -> Whitespace | PaddedStatements
PaddedStatements -> Whitespace? Statements Whitespace?
Statements -> SeparatedStatements? Statement
Statement -> FunctionCallStatement | BlockStatement
SeparatedStatements -> Statements Whitespace? Operator Whitespace?
Operator -> "," | "."
FunctionCallStatement -> FunctionCall
BlockStatement -> Block
FunctionCallStatement -> EndingWithWordFunctionCallSegments | EndingWithKnownFunctionCallSegments | EndingWithUnknownFunctionCallSegments
EndingWithWordFunctionCallSegments -> (SeparatedFunctionCallSegments | EndingWithKnownFunctionCallSegments | EndingWithUnknownFunctionCallSegments)? WordFunctionCallSegment
WordFunctionCallSegment -> Word
SeparatedFunctionCallSegments -> (EndingWithWordFunctionCallSegments | EndingWithKnownFunctionCallSegments | EndingWithUnknownFunctionCallSegments) Whitespace
EndingWithKnownFunctionCallSegments -> (SeparatedFunctionCallSegments | EndingWithKnownFunctionCallSegments | EndingWithUnknownFunctionCallSegments | EndingWithWordFunctionCallSegments)? KnownFunctionCallSegment
KnownFunctionCallSegment -> "(" KnownFunctionCallSegmentContent? ")"
KnownFunctionCallSegmentContent -> Whitespace | PaddedVariableName
EndingWithUnknownFunctionCallSegments -> (SeparatedFunctionCallSegments | EndingWithKnownFunctionCallSegments | EndingWithUnknownFunctionCallSegments | EndingWithWordFunctionCallSegments)? UnknownFunctionCallSegment
UnknownFunctionCallSegment -> "[" UnknownFunctionCallSegmentContent? "]"
UnknownFunctionCallSegmentContent -> Whitespace | PaddedVariableName
